顿	gbnm	gbnm
副	gklj	gklj
批	rxxn	rxxn
略	ltkg	ltkg
短	tdgu	tdgu
幻	xnn	xnn
沙	iitt	iitt
散	aety	aety
敌	tdty	tdty
乡	xte	xte
轮	lwxn	lwxn
朝	fjeg	fjeg
蕉	awyo	awyo
窗	pwtq	pwtq
忍	vynu	vynu
河	iskg	iskg
藏	adnt	aauh
冲	ukhh	ukhh
混	ijxx	ijxx
唯	kwyg	kwyg
冠	pfqf	pfqf
熟	ybvo	ybvo
蛋	nhju	nhju
尊	usgf	usgf
弃	ycaj	ycaj
敬	aqkt	aqkt
季	tbf	tbf
婚	vqaj	vqaj
县	egcu	egcu
紧	jcxi	jcxi
伯	wrg	wrg
申	jhk	jhk
衣	yeu	yeu
购	mqcy	mqcy
仅	wcy	wcy
帐	mhty	mhty
层	nfci	nfci
秋	toy	toy
猜	qtge	qtge
偏	wyna	wyna
镜	qujq	qujq
喝	kjqn	kjqn
偷	wwgj	wwgj
赞	tfqm	tfqm
犯	qtbn	qtbn
勇	celb	ceer
颗	jsdm	jsdm
姓	vtgg	vtgg
束	gkii	skd
淡	iooy	iooy
诗	yffy	yffy
晓	jatq	jatq
借	wajg	wajg
徒	tfhy	tfhy
洲	iyth	iyth
拥	reh	reh
序	ycbk	ocnh
庆	ydi	odi
绩	xgmy	xgmy
祝	pykq	pykq
围	lfnh	lfnh
余	wtu	wgsu
私	tcy	tcy
斗	ufk	ufk
柔	cbts	cnhs
漂	isfi	isfi
富	pgkl	pgkl
秀	teb	tbr
范	aibb	aibb
避	nkup	nkup
辉	iqpl	igql
译	ycfh	ycgh
孤	brcy	brcy
笨	tsgf	tsgf
括	rtdg	rtdg
吸	keyy	kbyy
端	umdj	umdj
移	tqqy	tqqy
厅	dsk	dsk
盖	uglf	uglf
末	gsi	gsi
察	pwfi	pwfi
抗	rymn	rywn
挥	rplh	rplh
积	tkwy	tkwy
插	rtfv	rtfe
惊	nyiy	nyiy
筑	tamy	tawy
忠	khnu	khnu
漫	ijlc	ijlc
辑	lkbg	lkbg
愈	wgen	wgen
梦	ssqu	ssqu
雪	fvf	fvf
巨	and	and
瑞	gmdj	gmdj
凡	myi	wyi
朱	rii	tfi
竹	ttgh	thth
粉	owvn	owvt
