促	wkhy	wkhy
晨	jdfe	jdfe
丢	tfcu	tfcu
盘	telf	tulf
偶	wjmy	wjmy
逐	epi	gepi
港	iawn	iawn
宫	pkkf	pkkf
宏	pdcu	pdcu
雅	ahty	ahty
货	wxmu	wxmu
醒	sgjg	sgjg
虚	haog	hod
遗	khgp	khgp
挂	rffg	rffg
透	tepv	tbpe
爆	ojai	ojai
烈	gqjo	gqjo
灭	goi	goi
材	sftt	sftt
拍	rrg	rrg
休	wsy	wsy
圆	lkmi	lkmi
银	qvey	qvy
互	gxgd	gxd
掌	ipkr	ipkr
豪	ypeu	ypge
替	fwfj	ggjf
挑	riqn	rqiy
顶	sdmy	sdmy
熊	cexo	cexo
累	lxiu	lxiu
址	fhg	fhg
健	wvfp	wvgp
鸡	cqyg	cqgg
困	lsi	lsi
诺	yadk	yadk
伴	wufh	wugh
玉	gyi	gyi
洗	itfq	itfq
敏	txgt	txty
临	jtyj	jtyj
街	tffh	tffs
降	btah	btgh
唸	kwyn	kwyn
怜	nwyc	nwyc
减	udgt	udgk
操	rkks	rkks
疯	umqi	uwri
辛	uygh	uygh
宇	pgfj	pgfj
聚	bcti	bciu
兮	wgnb	wgnb
彼	thcy	tby
届	nmd	nmd
尼	nxv	nxv
辈	djdl	hdhl
药	axqy	axqy
骗	cyna	cgya
绿	xviy	xviy
童	ujff	ujff
缩	xpwj	xpwj
符	twfu	twfu
获	aqtd	aqtd
默	lfod	lfod
碰	duog	duog
禁	ssfi	ssfi
婆	ihcv	ibvf
股	emcy	ewcy
抽	rmg	rmg
砍	dqwy	dqwy
恨	nvey	nvy
肯	hef	hef
泡	iqnn	iqnn
渐	ilrh	ilrh
钢	qmqy	qmry
废	ynty	onty
泪	ihg	ihg
赢	ynky	yemy
欧	aqqw	arqw
财	mftt	mftt
订	ysh	ysh
途	wtpi	wgsp
触	qejy	qejy
贤	jcmu	jcmu
杰	sou	sou
脱	eukq	eukq
箱	tshf	tshf
佈	wdmh	wdmh
睛	hgeg	hgeg
航	teym	tuyw
毫	yptn	ypeb
仙	wmh	wmh
吨	kgbn	kgbn
冰	uiy	uiy
析	srh	srh
苍	awbb	awbb
胃	lef	lef
贸	qyvm	qyvm
煤	oafs	ofsy
