阴	beg	beg
寂	phic	phic
探	rpws	rpws
迹	yopi	yopi
祖	pyeg	pyeg
迅	nfpk	nfpk
摩	yssr	ossr
距	khan	khan
剩	tuxj	tuxj
凉	uyiy	uyiy
遍	ynmp	ynmp
虫	jhny	jhny
召	vkf	vkf
烧	oatq	oatq
页	dmu	dmu
隆	btgg	btgg
弱	xuxu	xuxu
豆	gkuf	gkuf
延	thpd	thnp
握	rngf	rngf
宁	psj	psj
盟	jelf	jelf
覆	sttt	sttt
宪	ptfq	ptfq
秘	tntt	tntt
耐	dmjf	dmjf
丁	sgh	sgh
拨	rnty	rnty
沈	ipqn	ipqn
哀	yeu	yeu
眉	nhd	nhd
固	ldd	ldd
卷	udbb	ugbb
颜	utem	utem
稍	tieg	tieg
残	gqgt	gqga
搭	rawk	rawk
傻	wtlt	wtlt
耳	bghg	bghg
映	jmdy	jmdy
讬	ytan	ytan
恩	ldnu	ldnu
鸿	iaqg	iaqg
妙	vitt	vitt
辩	uyuh	uyuh
吵	kitt	kitt
拟	rnyw	rnyw
违	fnhp	fnhp
忧	ndnn	ndny
桌	hjsu	hjsu
拼	ruah	ruah
销	qieg	qieg
屋	ngcf	ngcf
域	fakg	fakg
洞	imgk	imgk
井	fjk	fjk
徐	twty	twgs
川	kthh	kthh
奈	dfiu	dfiu
户	yne	yne
乘	tuxv	tuxv
额	ptkm	ptkm
倍	wukg	wukg
摆	rlfc	rlfc
塞	pfjf	pawf
横	samw	samw
贺	lkmu	ekmu
皇	rgf	rgf
拖	rtbn	rtbn
怨	qbnu	qbnu
牙	ahte	ahte
齐	yjj	yjj
逃	iqpv	qipi
障	bujh	bujh
赚	muvo	muvw
滚	iuce	iuce
谱	yuoj	yuoj
乌	qngd	tnng
瞭	hdui	hdui
戴	falw	falw
搬	rtec	rtuc
瓜	rcyi	rcyi
迫	rpd	rpd
吓	kghy	kghy
奶	ven	vbt
棋	sadw	sdwy
泽	icfh	icgh
闹	uymh	uymh
盛	dnnl	dnlf
摸	rajd	rajd
尺	nyi	nyi
伙	woy	woy
染	ivsu	ivsu
佩	wmgh	wwgh
床	ysi	osi
酷	sgtk	sgtk
孙	biy	biy
诸	yftj	yftj
屁	nxxv	nxxv
醉	sgyf	sgyf
