做	wdty	wdty
常	ipkh	ipkh
您	wqin	wqin
见	mqb	mqb
里	jfd	jfd
东	aii	aii
风	mqi	wri
解	qevh	qevg
湾	iyox	iyox
月	eeee	eeee
等	tffu	tffu
部	ukbh	ukbh
原	drii	drii
美	ugdu	ugdu
先	tfqb	tfqb
音	ujf	ujf
通	cepk	cepk
管	tpnn	tpnf
区	aqi	ari
期	adwe	dweg
错	qajg	qajg
否	gikf	dhkf
乐	qii	tnii
入	tyi	tyi
找	rat	ray
书	nnhy	nnhy
让	yhg	yhg
四	lhng	lhng
由	mhng	mhng
选	tfqp	tfqp
较	luqy	lury
数	ovty	ovty
表	geu	geu
内	mwi	mwi
场	fnrt	fnrt
从	wwy	wwy
快	nnwy	nnwy
欢	cqwy	cqwy
至	gcff	gcff
立	uuuu	uuuu
目	hhhh	hhhh
社	pyfg	pyfg
合	wgkf	wgkf
望	yneg	yneg
怎	thfn	thfn
认	ywy	ywy
告	tfkf	tfkf
更	gjqi	gjri
几	mtn	wtn
考	ftgn	ftgn
度	yaci	oaci
难	cwyg	cwyg
版	thgc	thgc
头	udi	udi
喜	fkuk	fkuk
许	ytfh	ytfh
光	iqb	igqb
今	wynb	wynb
算	thaj	thaj
买	nudu	nudu
身	tmdt	tmdt
记	ynn	ynn
代	way	wayy
号	kgnb	kgnb
处	thi	thi
完	pfqb	pfqb
接	ruvg	ruvg
计	yfh	yfh
言	yyyy	yyyy
字	pbf	pbf
师	jgmh	jgmh
并	uaj	uaj
政	ghty	ghty
张	xtay	xtay
男	llb	ler
谁	ywyg	ywyg
山	mmmm	mmmm
每	txgu	txu
结	xfkg	xfkg
且	egd	egd
星	jtgf	jtgf
非	djdd	hdhd
建	vfhp	vgpk
改	nty	nty
连	lpk	lpk
放	yty	yty
京	yiu	yiu
活	itdg	itdg
站	uhkg	uhkg
研	dgah	dgah
直	fhf	fhf
设	ymcy	ywcy
陈	baiy	baiy
报	rbcy	rbcy
转	lfny	lfny
党	ipkq	ipkq
指	rxjg	rxjg
五	gghg	gghg
变	yocu	yocu
气	rnb	rtgn