雄	dcwy	dcwy
深	ipws	ipws
票	sfiu	sfiu
早	jhnh	jhnh
院	bpfq	bpfq
够	qkqq	qkqq
曲	mad	mad
假	wnhc	wnhc
谈	yooy	yooy
术	syi	syi
卖	fnud	fnud
黑	lfou	lfou
百	djf	djf
胜	etgg	etgg
推	rwyg	rwyg
存	dhbd	dhbd
火	oooo	oooo
准	uwyg	uwyg
示	fiu	fiu
往	tygg	tygg
易	jqrr	jqrr
况	ukqn	ukqn
晚	jqkq	jqkq
离	ybmc	yrbc
治	ickg	ickg
导	nfu	nfu
七	agn	agn
段	wdmc	thdc
团	lfte	lfte
调	ymfk	ymfk
证	yghg	yghg
列	gqjh	gqjh
伤	wtln	wtet
永	ynii	ynii
刚	mqjh	mrjh
排	rdjd	rhdd
哥	sksk	sksk
德	tfln	tfln
九	vtn	vtn
甚	adwn	dwnb
杀	qsu	rsu
照	jvko	jvko
包	qnv	qnv
怕	nrg	nrg
条	tsu	tsu
夜	ywty	ywty
商	umwk	yumk
概	svcq	svaq
根	svey	svy
供	wawy	wawy
绝	xqcn	xqcn
千	tfk	tfk
客	ptkf	ptkf
切	avn	avt
集	wysu	wysu
称	tqiy	tqiy
据	rndg	rndg
落	aitk	aitk
越	fhat	fhan
竟	ujqb	ujqb
尽	nyuu	nyuu
待	tffy	tffy
闻	ubd	ubd
园	lfqv	lfqv
忘	ynnu	ynnu
值	wfhg	wfhg
产	ute	ute
消	iieg	iieg
双	ccy	ccy
红	xag	xag
座	ywwf	owwf
展	naei	naei
育	ycef	ycef
跑	khqn	khqn
附	bwfy	bwfy
执	rvyy	rvyy
唱	kjjg	kjjg
技	rfcy	rfcy
某	afsu	fsu
硬	dgjq	dgjr
斯	adwr	dwrh
云	fcu	fcu
息	thnu	thnu
助	egln	eget
袜	pugs	pugs
须	edmy	edmy
苦	adf	adf
劳	aplb	aper
弟	uxht	uxht
赛	pfjm	pawm
啦	krug	krug
食	wyve	wyvu
哈	kwgk	kwgk
迷	opi	opi
济	iyjh	iyjh
介	wjj	wjj
效	uqty	urty
占	hkf	hkf
农	pei	pei
首	uthf	uthf
