亦	you	you
味	kfiy	kfy
评	yguh	yguf
舞	rlgh	tglg
细	xlg	xlg
医	atdi	atdi
帝	upmh	yuph
属	ntky	ntky
句	qkd	qkd
恋	yonu	yonu
败	mty	mty
宜	pegf	pegf
杨	snrt	snrt
甲	lhnh	lhnh
追	wnnp	tnpd
春	dwjf	dwjf
左	daf	daf
敢	nbty	nbty
灵	vou	vou
际	bfiy	bfiy
群	vtkd	vtku
族	yttd	yttd
木	ssss	ssss
骑	cdsk	cgdk
项	admy	admy
戏	cat	cay
遇	jmhp	jmhp
狗	qtqk	qtqk
佳	wffg	wffg
博	fgef	fsfy
右	dkf	dkf
痛	ucek	ucek
营	apkk	apkk
妹	vfiy	vfy
康	yvii	ovii
善	uduk	uukf
征	tghg	tghg
历	dlv	dee
官	pnhn	pnf
尔	qiu	qiu
按	rpvg	rpvg
编	xyna	xyna
病	ugmw	ugmw
护	rynt	rynt
补	puhy	puhy
择	rcfh	rcgh
抓	rrhy	rrhy
石	dgtg	dgtg
岁	mqu	mqu
领	wycm	wycm
寻	vfu	vfu
温	ijlg	ijlg
养	udyj	ugjj
止	hhhg	hhgg
守	pfu	pfu
君	vtkd	vtkf
血	tld	tld
田	llll	llll
雨	fghy	fghy
居	ndd	ndd
谓	yleg	yleg
异	naj	naj
优	wdnn	wdny
跳	khiq	khqi
拜	rdfh	rdfh
烂	oufg	oudg
封	fffy	fffy
恶	gogn	gonu
良	yvei	yvi
模	sajd	sajd
状	udy	udy
浪	iyve	iyvy
增	fulj	fulj
核	synw	synw
激	iryt	iryt
维	xwyg	xwyg
陆	bfmh	bgbh
吴	kgdu	kgdu
牛	rhk	tgk
忙	nynn	nynn
词	yngk	yngk
剧	ndjh	ndjh
急	qvnu	qvnu
啥	kwfk	kwfk
抱	rqnn	rqnn
静	geqh	geqh
粮	oyve	oyvy
嗲	kwqq	kwrq
醋	sgaj	sgaj
攻	aty	aty
庭	ytfp	otfp
汽	irnn	irn
软	lqwy	lqwy
兄	kqb	kqb
夏	dhtu	dhtu
苏	alwu	aewu
沉	ipmn	ipwn
佔	whkg	whkg
刊	fjh	fjh
亚	gogd	god
