采	esu	esu
船	temk	tuwk
江	iag	iag
致	gcft	gcft
淇	iadw	idwy
阵	blh	blh
严	godr	gote
宗	pfiu	pfiu
警	aqky	aqky
夫	fwi	gggy
密	pntm	pntm
睡	htgf	htgf
午	tfj	tfj
店	yhkd	ohkd
势	rvyl	rvye
悲	djdn	hdhn
兰	uff	udf
幕	ajdh	ajdh
厂	dgt	dgt
签	twgi	twgg
坐	wwff	wwfd
香	tjf	tjf
控	rpwa	rpwa
微	tmgt	tmgt
登	wgku	wgku
翻	toln	toln
普	uogj	uojf
冷	uwyc	uwyc
威	dgvt	dgvd
毒	gxgu	gxu
络	xtkg	xtkg
母	xgui	xnny
创	wbjh	wbjh
堂	ipkf	ipkf
赵	fhqi	fhri
套	ddu	ddu
旧	hjg	hjg
杂	vsu	vsu
述	sypi	sypi
恐	amyn	awyn
幸	fufj	fufj
亮	ypmb	ypwb
丽	gmyy	gmyy
巴	cnhn	cnhn
礼	pynn	pynn
酒	isgg	isgg
仁	wfg	wfg
餐	hqce	hqcv
牌	thgf	thgf
突	pwdu	pwdu
脚	efcb	efcb
剑	wgij	wgij
招	rvkg	rvkg
吉	fkf	fkf
父	wqu	wru
仔	wbg	wbg
典	mawu	mawu
搞	rymk	rymk
房	ynyv	ynye
素	gxiu	gxiu
防	byn	byt
授	repc	repc
充	ycqb	ycqb
草	ajj	ajj
暴	jawi	jawi
虑	hani	hni
绍	xvkg	xvkg
背	uxef	uxef
刘	yjh	yjh
委	tvf	tvf
府	ywfi	owfi
景	jyiu	jyiu
忆	nnn	nnn
尤	dnv	dnyi
缺	rmnw	tfbw
援	refc	regc
琴	ggwn	ggwn
骂	kkcf	kkcg
纯	xgbn	xgbn
尚	imkf	imkf
艺	anb	anb
惜	najg	najg
置	lfhf	lfhf
益	uwlf	uwlf
姐	vegg	vegg
诚	ydnt	ydnn
继	xonn	xonn
湖	ideg	ideg
欲	wwkw	wwkw
麻	yssi	ossi
靠	tfkd	tfkd
智	tdkj	tdkj
米	oyty	oyty
枪	swbn	swbn
村	sfy	sfy
肉	mwwi	mwwi
松	swcy	swcy
企	whf	whf
州	ytyh	ytyh
升	tak	tak
