刻	yntj	yntj
纪	xnn	xnn
退	vepi	vpi
既	vcaq	vaqn
含	wynk	wynk
判	udjh	ugjh
释	toch	tocg
皮	hci	bnty
波	ihcy	iby
承	bdii	bdii
射	tmdf	tmdf
堆	fwyg	fwyg
莫	ajdu	ajdu
键	qvfp	qvgp
赶	fhfk	fhfk
旁	upyb	yupy
笔	ttfn	teb
奏	dwgd	dwgd
树	scfy	scfy
律	tvfh	tvgh
铁	qrwy	qtgy
荣	apsu	apsu
昨	jthf	jthf
毛	tfnv	etgn
彩	eset	eset
归	jvg	jvg
虎	hamv	hwv
罪	ldjd	lhdd
皆	xxrf	xxrf
叶	kfh	kfh
售	wykf	wykf
弹	xujf	xujf
卫	bgd	bgd
施	ytbn	ytbn
刀	vnt	vnt
块	fnwy	fnwy
汉	icy	icy
欣	rqwy	rqwy
布	dmhj	dmhj
赏	ipkm	ipkm
载	falk	fald
险	bwgi	bwgg
播	rtol	rtol
钟	qkhh	qkhh
寄	pdsk	pdsk
弄	gaj	gaj
付	wfy	wfy
构	sqcy	sqcy
囉	klxy	klxy
伟	wfnh	wfnh
洋	iudh	iuh
启	ynkd	ynkd
梅	stxu	stxy
策	tgmi	tsmb
灯	osh	osh
鬼	rqci	rqci
检	swgi	swgg
宣	pgjg	pgjg
妈	vcg	vcgg
均	fqug	fqug
派	irey	irey
猪	qtfj	qtfj
架	lksu	eksu
享	ybf	ybf
呆	ksu	ksu
训	ykh	ykh
蓝	ajtl	ajtl
划	ajh	ajh
担	rjgg	rjgg
努	vclb	vcer
郭	ybbh	ybbh
纸	xqan	xqan
贴	mhkg	mhkg
暗	jujg	jujg
呼	ktuh	ktuf
罢	lfcu	lfcu
巧	agnn	agnn
慧	dhdn	dhdn
穿	pwat	pwat
详	yudh	yuh
雷	flf	flf
协	flwy	fewy
督	hich	hich
邓	cbh	cbh
艰	cvey	cvy
猫	qtal	qtal
贫	wvmu	wvmu
妇	vvg	vvg
讯	ynfh	ynfh
缘	xxey	xxey
顾	dbdm	dbdm
脸	ewgi	ewgg
逢	tdhp	tdhp
岛	qynm	qmk
奖	uqdu	uqdu
亿	wnn	wnn
狂	qtgg	qtgg
础	dbmh	dbmh
鲜	qgud	qguh
访	yyn	yyt
