的	rqyy	rqyy
是	jghu	jghu
不	gii	dhi
我	trnt	trny
一	ggll	ggll
有	def	def
大	dddd	dddd
在	dhfd	dhfd
人	wwww	wwww
了	bnh	bnh
中	khk	khk
到	gcfj	gcfj
资	uqwm	uqwm
要	svf	svf
以	nywy	nywy
可	skd	skd
这	ypi	ypi
个	whj	whj
你	wqiy	wqiy
会	wfcu	wfcu
好	vbg	vbg
为	ylyi	yeyi
上	hhgg	hhgg
来	goi	gusi
学	ipbf	ipbf
就	yidn	yidy
交	uqu	uru
也	bnhn	bnhn
用	etnh	etnh
能	cexx	cexx
如	vkg	vkg
时	jfy	jfy
文	yygy	yygy
说	yukq	yukq
没	imcy	iwcy
他	wbn	wbn
看	rhf	rhf
那	vfbh	ngbh
问	ukd	ukd
生	tgd	tgd
提	rjgh	rjgh
下	ghi	ghi
过	fpi	fpi
请	ygeg	ygeg
们	wun	wun
天	gdi	gdi
所	rnrh	rnrh
多	qqu	qqu
么	tcu	tcu
小	ihty	ihty
之	pppp	pppp
想	shnu	shnu
得	tjgf	tjgf
工	aaaa	aaaa
出	bmk	bmk
还	gipi	dhpi
电	jnv	jnv
对	cfy	cfy
都	ftjb	ftjb
机	smn	swn
自	thd	thd
而	dmjj	dmjj
子	bbbb	bbbb
后	rgkd	rgkd
家	peu	pgeu
心	nyny	nyny
只	kwu	kwu
去	fcu	fcu
知	tdkg	tdkg
国	lgyi	lgyi
很	tvey	tvy
台	ckf	ckf
成	dnnt	dnv
信	wyg	wyg
同	mgkd	mgkd
何	wskg	wskg
道	uthp	uthp
发	ntyc	ntcy
地	fbn	fbn
法	ifcy	ifcy
无	fqv	fqv
然	qdou	qdou
但	wjgg	wjgg
当	ivf	ivf
于	gfk	gfk
吗	kcg	kcgg
本	sgd	sgd
年	rhfk	tgj
现	gmqn	gmqn
前	uejj	uejj
最	jbcu	jbcu
真	fhwu	fhwu
新	usrh	usrh
和	tkg	tkg
因	ldi	ldi
果	jsi	jsi
意	ujnu	ujnu
定	pghu	pghu
点	hkou	hkou
情	ngeg	ngeg