夺	dfu	dfu
厌	ddi	ddi
丈	dyi	dyi
铜	qmgk	qmgk
返	rcpi	rcpi
叹	kcy	kcy
沿	imkg	iwkg
悄	nieg	nieg
纺	xyn	xyt
汇	ian	ian
饱	qnqn	qnqn
臭	thdu	thdu
籍	tdij	tfsj
坚	jcff	jcff
哭	kkdu	kkdu
懒	ngkm	nskm
桥	stdj	stdj
稳	tqvn	tqvn
症	ughd	ughd
露	fkhk	fkhk
询	yqjg	yqjg
森	sssu	sssu
丝	xxgf	xxgf
尘	iff	iff
阻	begg	begg
惯	nxfm	nxmy
涛	idtf	idtf
茶	awsu	awsu
赖	gkim	skqm
阶	bwjh	bwjh
丰	dhk	dhk
贝	mhny	mhny
邮	mbh	mbh
危	qdbb	qdbb
寒	pfju	pawu
械	saah	saah
隐	bqvn	bqvn
爸	wqcb	wrcb
惨	ncde	ncde
旅	ytey	ytey
予	cbj	cnhj
振	rdfe	rdfe
亡	ynv	ynb
瓶	uagn	uagy
遭	gmap	gmap
哲	rrkf	rrkf
零	fwyc	fwyc
纳	xmwy	xmwy
珍	gwet	gwet
乃	etn	bnt
哩	kjfg	kjfg
郑	udbh	udbh
吹	kqwy	kqwy
骨	mef	mef
烟	oldy	oldy
胡	deg	deg
伦	wwxn	wwxn
洪	iawy	iawy
摇	rerm	retb
娘	vyve	vyvy
芳	ayb	ayr
索	fpxi	fpxi
峰	mtdh	mtdh
织	xkwy	xkwy
惠	gjhn	gjhn
闲	usi	usi
杯	sgiy	sdhy
浮	iebg	iebg
狼	qtye	qtyv
隔	bgkh	bgkh
椰	sbbh	sbbh
租	tegg	tegg
尾	ntfn	nev
忽	qrnu	qrnu
庄	yfd	ofd
款	ffiw	ffiw
菜	aesu	aesu
折	rrh	rrh
扰	rdnn	rdny
扬	rnrt	rnrt
鼠	vnun	enun
冒	jhf	jhf
鼓	fkuc	fkuc
刺	gmij	smjh
频	hidm	hhdm
喵	kalg	kalg
针	qfh	qfh
谋	yafs	yfsy
稿	tymk	tymk
穷	pwlb	pwer
磁	duxx	duxx
霸	fafe	fafe
暂	lrjf	lrjf
税	tukq	tukq
伊	wvtt	wvtt
托	rtan	rtan
嘴	khxe	khxe
库	ylk	olk
悔	ntxu	ntxy
揭	rjqn	rjqn
