震	fdfe	fdfe
锁	qimy	qimy
凯	mnmn	mnwn
损	rkmy	rkmy
潮	ifje	ifje
役	tmcy	twcy
涌	iceh	iceh
泰	dwiu	dwiu
伍	wgg	wgg
冬	tuu	tuu
桃	siqn	sqiy
聪	bukn	bukn
乙	nnll	nnll
迴	lkpd	lkpd
竞	ukqb	ukqb
崇	mpfi	mpfi
撞	rujf	rujf
厉	ddnv	dgqe
净	uqvh	uqvh
牵	dprh	dptg
羊	udj	uyth
溪	iexd	iexd
帽	mhjh	mhjh
眠	hnan	hnan
巷	awnb	awnb
沟	iqcy	iqcy
俗	wwwk	wwwk
宋	psu	psu
飘	sfiq	sfir
浅	igt	igay
献	fmud	fmud
舰	temq	tumq
滑	imeg	imeg
榜	supy	syuy
圈	ludb	lugb
纵	xwwy	xwwy
闪	uwi	uwi
莲	alpu	alpu
麦	gtu	gtu
邦	dtbh	dtbh
耀	iqny	igqy
旋	ytnh	ytnh
阅	uukq	uukq
谅	yyiy	yyiy
紫	hxxi	hxxi
摄	rbcc	rbcc
仪	wyqy	wyry
妨	vyn	vyt
审	pjhj	pjhj
描	ralg	ralg
毁	vamc	eawc
陪	bukg	bukg
填	ffhw	ffhw
踏	khij	khij
跌	khrw	khtg
藤	aeui	aeui
慕	ajdn	ajdn
勒	afln	afet
殊	gqri	gqtf
凭	wtfm	wtfw
寞	pajd	pajd
岸	mdfj	mdfj
芬	awvb	awvr
镇	qfhw	qfhw
池	ibn	ibn
拒	rang	rang
锋	qtdh	qtdh
宽	pamq	pamq
拳	udrj	ugrj
函	bibk	bibk
驱	caqy	cgar
裁	faye	faye
蟹	qevj	qevj
颇	hcdm	bdmy
卧	ahnh	ahnh
昌	jjf	jjf
孟	blf	blf
巩	amyy	awyy
匆	qryi	qryi
肃	vijk	vhjw
萧	avij	avhw
措	rajg	rajg
垂	tgaf	tgaf
腐	ywfw	owfw
郎	yvcb	yvbh
矛	cbtr	cnht
嘛	kyss	koss
梁	ivws	ivws
凤	mci	wci
遥	ermp	etfp
咨	uqwk	uqwk
厦	ddht	ddht
档	sivg	sivg
蠍	jjqw	jjqw
恭	awnu	awnu
铺	qgey	qsy
矿	dyt	dot
扎	rnn	rnn
袖	pumg	pumg
奥	tmod	tmod
