歉	uvow	uvjw
寸	fghy	fghy
刑	gajh	gajh
塔	fawk	fawk
棍	sjxx	sjxx
闭	ufte	ufte
肺	egmh	egmh
晒	jsg	jsg
糊	odeg	odeg
仰	wqbh	wqbh
旗	ytaw	ytdw
励	ddnl	dgqe
厚	djbd	djbd
魂	fcrc	fcrc
斤	rtth	rtth
综	xpfi	xpfi
宙	pmf	pmf
舒	wfkb	wfkh
兼	uvou	uvjw
萨	abut	abut
饮	qnqw	qnqw
赤	fou	fou
阁	utkd	utkd
庸	yveh	oveh
抢	rwbn	rwbn
勿	qre	qre
绪	xftj	xftj
扫	rvg	rvg
慈	uxxn	uxxn
栏	sufg	sudg
尝	ipfc	ipfc
劝	cln	cet
奋	dlf	dlf
喊	kdgt	kdgk
幽	xxmk	mxxi
扩	ryt	rot
污	ifnn	ifnn
祥	pyud	pyuh
盗	uqwl	uqwl
罚	lyjj	lyjj
番	tolf	tolf
尖	idu	idu
灰	dou	dou
狐	qtry	qtry
衡	tqdh	tqds
汪	igg	igg
监	jtyl	jtyl
筹	tdtf	tdtf
迟	nypi	nypi
夸	dfnb	dfnb
浩	itfk	itfk
拆	rryy	rryy
纷	xwvn	xwvt
吾	gkf	gkf
姑	vdg	vdg
咱	kthg	kthg
漏	infy	infy
诞	ythp	ythp
淑	ihic	ihic
郁	debh	debh
砲	dqnn	dqnn
墙	ffuk	ffuk
窝	pwkw	pwkw
倾	wxdm	wxdm
辞	tduh	tduh
秒	titt	titt
羽	nnyg	nnyg
渡	iyac	ioac
辆	lgmw	lgmw
龄	hwbc	hwbc
培	fukg	fukg
邀	rytp	rytp
辟	nkuh	nkuh
甘	afd	fghg
袋	waye	waye
杜	sfg	sfg
酸	sgct	sgct
狸	qtjf	qtjf
腾	eudc	eugg
稀	tqdh	trdh
炼	oanw	oanw
胸	eqqb	eqrb
肥	ecn	ecn
锅	qkmw	qkmw
挺	rtfp	rtfp
纽	xnfg	xnhg
贯	xfmu	xmu
泛	itpy	itpy
棉	srmh	srmh
汗	ifh	ifh
仿	wyn	wyt
侧	wmjh	wmjh
谷	wwkf	wwkf
兽	ulgk	ulgk
娃	vffg	vffg
孔	bnn	bnn
陷	bqvg	bqeg
估	wdg	wdg
妻	gvhv	gvhv
径	tcag	tcag
