渴	ijqn	ijqn
荡	ainr	ainr
玫	gty	gty
盐	fhlf	fhlf
寓	pjmy	pjmy
潜	ifwj	iggj
晶	jjjf	jjjf
胞	eqnn	eqnn
脆	eqdb	eqdb
抹	rgsy	rgsy
爽	dqqq	drrr
犹	qtdn	qtdy
吕	kkf	kkf
姨	vgxw	vgxw
碎	dywf	dywf
喷	kfam	kfam
截	fawy	fawy
旦	jgf	jgf
聊	bqtb	bqtb
垃	fug	fug
荒	aynq	aynk
币	tmhk	tmhk
躺	tmdk	tmdk
遵	usgp	usgp
挣	rqvh	rqvh
灌	iaky	iaky
魔	yssc	ossc
圾	feyy	fbyy
串	kkhk	kkhk
壮	ufg	ufg
伸	wjhh	wjhh
傲	wgqt	wgqt
弦	xyxy	xyxy
泥	inxn	inxn
繁	txgi	txti
鲁	qgjf	qgjf
忌	nnu	nnu
叭	kwy	kwy
坦	fjgg	fjgg
耻	bhg	bhg
蜜	pntj	pntj
欺	adww	dwqw
玲	gwyc	gwyc
唐	yvhk	ovhk
汤	inrt	inrt
悉	tonu	tonu
劲	caln	caet
拔	rdcy	rdcy
甜	tdaf	tdfg
蒙	apge	apfe
逛	qtgp	qtgp
朵	msu	wsu
摘	rumd	ryud
胆	ejgg	ejgg
糟	ogmj	ogmj
腿	evep	evpy
喇	kgkj	kskj
丑	nfd	nhgg
跃	khtd	khtd
泉	riu	riu
碧	grdf	grdf
鞋	afff	afff
韩	fjfh	fjfh
驾	lkcf	ekcg
猛	qtbl	qtbl
缓	xefc	xegc
坡	fhcy	fby
脉	eyni	eyni
炸	othf	othf
怒	vcnu	vcnu
桂	sffg	sffg
纠	xnhh	xnhh
贷	wamu	waym
凶	qbk	rbk
饿	qntt	qnty
牢	prhj	ptgj
舅	vllb	eler
愤	nfam	nfam
伏	wdy	wdy
邪	ahtb	ahtb
峡	mguw	mgud
盒	wgkl	wgkl
塘	fyvk	fovk
纹	xyy	xyy
湿	ijog	ijog
粒	oug	oug
捕	rgey	rsy
幼	xln	xet
津	ivfh	ivgh
艾	aqu	aru
恒	ngjg	ngjg
割	pdhj	pdhj
扯	rhg	rhg
盾	rfhd	rfhd
幺	xnny	xxxx
吐	kfg	kfg
昏	qajf	qajf
辨	uytu	uytu
丹	myd	myd
鉴	jtyq	jtyq
