暑	jftj	jftj
弯	yoxb	yoxb
侵	wvpc	wvpc
胎	eckg	eckg
悠	whtn	whtn
薪	ausr	ausr
彬	sset	sset
悟	ngkg	ngkg
珠	griy	gtfy
勤	akgl	akge
瑰	grqc	grqc
植	sfhg	sfhg
碍	djgf	djgf
厘	djfd	djfd
盼	hwvn	hwvt
亨	ybj	ybj
剪	uejv	uejv
谊	ypeg	ypeg
滩	icwy	icwy
愁	tonu	tonu
磨	yssd	ossd
逼	gklp	gklp
浓	ipey	ipey
洛	itkg	itkg
乏	tpi	tpu
挡	rivg	rivg
姆	vxgu	vxy
躲	tmds	tmds
壁	nkuf	nkuf
钓	qqyy	qqyy
暖	jefc	jegc
憾	ndgn	ndgn
愉	nwgj	nwgj
曰	jhng	jhng
捷	rgvh	rgvh
玄	yxu	yxu
炒	oitt	oitt
瘦	uvhc	uehc
掩	rdjn	rdjn
债	wgmy	wgmy
悬	egcn	egcn
撒	raet	raet
鸭	lqyg	lqgg
臂	nkue	nkue
册	mmgd	mmgd
滴	iumd	iyud
扣	rkg	rkg
抵	rqay	rqay
奔	dfaj	dfaj
翁	wcnf	wcnf
蹟	khgm	khgm
爬	rhyc	rhyc
棚	seeg	seeg
夕	qtny	qtny
恼	nybh	nyrb
戒	aak	aak
牲	trtg	ctgg
泳	iyni	iyni
恰	nwgk	nwgk
沧	iwbn	iwbn
桑	cccs	cccs
蒋	auqf	auqf
洁	ifkg	ifkg
岗	mmqu	mmru
焦	wyou	wyou
勉	qkql	qkqe
莱	agou	agus
咖	klkg	kekg
贪	wynm	wynm
踢	khjr	khjr
抄	ritt	ritt
涯	idff	idff
箭	tuej	tuej
誓	rryf	rryf
涉	ihit	ihht
叙	wtcy	wgsc
署	lftj	lftj
疗	ubk	ubk
倡	wjjg	wjjg
扑	rhy	rhy
剥	vijh	vijh
敲	ymkc	ymkc
赴	fhhi	fhhi
侨	wtdj	wtdj
润	iugg	iugg
屈	nbmk	nbmk
澳	itmd	itmd
雾	ftlb	fter
疲	uhci	ubi
削	iejh	iejh
埃	fctd	fctd
宿	pwdj	pwdj
灾	pou	pou
纱	xitt	xitt
冻	uaiy	uaiy
腔	epwa	epwa
俱	whwy	whwy
彻	tavn	tavt
屠	nftj	nftj
牺	trsg	csg
