绕	xatq	xatq
寿	dtfu	dtfu
氏	qav	qav
蔬	anhq	anhk
筷	tnnw	tnnw
倚	wdsk	wdsk
吞	gdkf	gdkf
翼	nlaw	nlaw
斜	wtuf	wgsf
蝇	jkjn	jkjn
扶	rfwy	rgy
冶	uckg	uckg
拦	rufg	rudg
肚	efg	efg
咪	koy	koy
绘	xwfc	xwfc
廉	yuvo	ouvw
鸣	kqyg	kqgg
貌	eerq	erqn
炮	oqnn	oqnn
脖	efpb	efpb
捐	rkeg	rkeg
啡	kdjd	khdd
炎	oou	oou
贡	amu	amu
锂	qjfg	qjfg
曼	jlcu	jlcu
鼻	thlj	thlj
奉	dwfh	dwgj
铃	qwyc	qwyc
耗	ditn	fsen
恢	ndoy	ndoy
融	gkmj	gkmj
筋	telb	teer
捡	rwgi	rwgg
饰	qnth	qnth
祸	pykw	pykw
唬	kham	khwn
挖	rpwn	rpwn
幅	mhgl	mhgl
瞧	hwyo	hwyo
撑	ripr	ripr
柳	sqtb	sqtb
薄	aigf	aisf
黎	tqti	tqti
捲	rudb	rugb
吊	kmhj	kmhj
挤	ryjh	ryjh
览	jtyq	jtyq
迪	mpd	mpd
凌	ufwt	ufwt
茫	aiyn	aiyn
燃	oqdo	oqdo
玛	gcg	gcgg
锦	qrmh	qrmh
宾	prgw	prwu
梯	suxt	suxt
狱	qtyd	qtyd
咬	kuqy	kury
墨	lfof	lfof
闷	uni	uni
晴	jgeg	jgeg
怖	ndmh	ndmh
乔	tdjj	tdjj
齿	hwbj	hwbj
岭	mwyc	mwyc
仲	wkhh	wkhh
韵	ujqu	ujqu
旭	vjd	vjd
兔	qkqy	qkqy
踪	khpi	khpi
姿	uqwv	uqwv
迈	dnpv	gqpe
傢	wpey	wpge
誉	iwyf	igwy
裤	puyl	puol
孝	ftbf	ftbf
驶	ckqy	cgkr
裕	puwk	puwk
伪	wyly	wyey
仇	wvn	wvn
辽	bpk	bpk
衰	ykge	ykge
雇	ynwy	ynwy
胁	elwy	eewy
粗	oegg	oegg
牧	trty	cty
舟	tei	tui
糕	ougo	ougo
壳	fpmb	fpwb
蝶	jans	jans
兇	qbqb	rbqb
惧	nhwy	nhwy
锐	qukq	qukq
吟	kwyn	kwyn
亏	fnv	fnb
剂	yjjh	yjjh
枝	sfcy	sfcy
耍	dmjv	dmjv
阔	uitd	uitd
