疼	utui	utui
拾	rwgk	rwgk
毅	uemc	uewc
刷	nmhj	nmhj
涂	iwty	iwgs
夹	guwi	gudi
禽	wybc	wyrc
裂	gqje	gqje
邻	wycb	wycb
悦	nukq	nukq
契	dhvd	dhvd
轰	lccu	lccu
爵	elvf	elvf
渠	ians	ians
屏	nuak	nuak
驻	cygg	cgyg
赌	mftj	mftj
蜂	jtdh	jtdh
扇	ynnd	ynnd
羞	udnf	unhg
瓦	gnyn	gnny
疏	nhyq	nhyk
坤	fjhh	fjhh
堪	fadn	fdwn
洩	ijxt	ijnt
逆	ubtp	ubtp
抬	rckg	rckg
哎	kaqy	kary
饼	qnua	qnua
弥	xqiy	xqiy
纲	xmqy	xmry
惹	adkn	adkn
翘	atgn	atgn
堕	bdef	bdef
狠	qtve	qtvy
顽	fqdm	fqdm
莎	aiit	aiit
擦	rpwi	rpwi
赠	mulj	mulj
凝	uxth	uxth
滋	iuxx	iuxx
逝	rrpk	rrpk
允	cqb	cqb
彭	fkue	fkue
抛	rvln	rvet
愚	jmhn	jmhn
辱	dfef	dfef
朗	yvce	yveg
慰	nfin	nfin
禅	pyuf	pyuf
蛙	jffg	jffg
秦	dwtu	dwtu
侦	whmy	whmy
椅	sdsk	sdsk
夥	jsqq	jsqq
碗	dpqb	dpqb
吁	kgfh	kgfh
丙	gmwi	gmwi
荷	awsk	awsk
披	rhcy	rby
趋	fhqv	fhqv
劫	fcln	fcet
笛	tmf	tmf
烤	oftn	oftn
肩	yned	yned
迁	tfpk	tfpk
鹿	ynjx	oxxv
缸	rmag	tfba
慾	wwkn	wwkn
炉	oynt	oynt
魅	rqci	rqcf
巡	vpv	vpv
钙	qghn	qghn
晏	jpvf	jpvf
秤	tguh	tguf
痕	uvei	uvi
堵	fftj	fftj
滥	ijtl	ijtl
歧	hfcy	hfcy
盯	hsh	hsh
涨	ixty	ixty
盲	ynhf	ynhf
岩	mdf	mdf
朴	shy	shy
腰	esvg	esvg
贱	mgt	mgay
偿	wipc	wipc
妥	evf	evf
液	iywy	iywy
鹅	trng	trng
轨	lvn	lvn
叔	hicy	hicy
陵	bfwt	bfwt
粥	xoxn	xoxn
渔	iqgg	iqgg
铭	qqkg	qqkg
脂	exjg	exjg
鹰	ywwg	owwg
稻	tevg	teeg
俊	wcwt	wcwt
