脑	eybh	eyrb
朋	eeg	eeg
格	stkg	stkg
儿	qtn	qtn
八	wty	wty
修	whte	whte
料	oufh	oufh
钱	qgt	qgay
失	rwi	tgi
吃	ktnn	ktnn
住	wygg	wygg
即	vcbh	vbh
另	klb	ker
录	viu	viu
专	fnyi	fnyi
象	qjeu	qkeu
换	rqmd	rqmd
基	adwf	dwff
板	srcy	srcy
拿	wgkr	wgkr
远	fqpv	fqpv
速	gkip	skpd
形	gaet	gaet
孩	bynw	bynw
备	tlf	tlf
歌	sksw	sksw
帮	dtbh	dtbh
确	dqeh	dqeh
候	whnd	whnd
除	bwty	bwgs
界	lwjj	lwjj
装	ufye	ufye
类	odu	odu
讲	yfjh	yfjh
器	kkdk	kkdk
南	fmuf	fmuf
案	pvsu	pvsu
画	glbj	glbj
英	amdu	amdu
诉	yryy	yryy
带	gkph	gkph
差	udaf	uaf
乎	tuhk	tufk
量	jgjf	jgjf
久	qyi	qyi
掉	rhjh	rhjh
似	wnyw	wnyw
整	gkih	skth
引	xhh	xhh
班	gytg	gytg
图	ltui	ltui
制	rmhj	tgmj
费	xjmu	xjmu
奇	dskf	dskf
识	ykwy	ykwy
型	gajf	gajf
超	fhvk	fhvk
边	lpv	epe
品	kkkf	kkkf
舍	wfkf	wfkf
虽	kju	kju
始	vckg	vckg
运	fcpi	fcpi
李	sbf	sbf
务	tlb	ter
权	scy	scy
验	cwgi	cgwg
故	dty	dty
六	uygy	uygy
读	yfnd	yfnd
怪	ncfg	ncfg
飞	nui	nui
满	iagw	iagw
服	ebcy	ebcy
收	nhty	nhty
眼	hvey	hvy
造	tfkp	tfkp
念	wynn	wynn
留	qyvl	qyvl
革	afj	afj
课	yjsy	yjsy
游	iytb	iytb
军	plj	plj
饭	qnrc	qnrc
著	aftj	aftj
席	yamh	oamh
破	dhcy	dby
精	ogeg	ogeg
半	ufk	ugk
玩	gfqn	gfqn
讨	yfy	yfy
约	xqyy	xqyy
愿	drin	drin
令	wycu	wycu
网	mqqi	mrri
底	yqay	oqay
答	twgk	twgk
统	xycq	xycq
演	ipgw	ipgw
达	dpi	dpi
