质	rfmi	rfmi
例	wgqj	wgqj
职	bkwy	bkwy
复	tjtu	tjtu
输	lwgj	lwgj
节	abj	abj
规	fwmq	gmqn
注	iygg	iygg
毕	xxfj	xxfj
查	sjgf	sjgf
热	rvyo	rvyo
油	img	img
馆	qnpn	qnpn
态	dynu	dynu
停	wyps	wyps
福	pygl	pygl
救	fiyt	giyt
倒	wgcj	wgcj
亲	usu	usu
害	pdhk	pdhk
乱	tdnn	tdnn
古	dghg	dghg
步	hir	hhr
宝	pgyu	pgyu
击	fmk	gbk
举	iwfh	igwg
终	xtuy	xtuy
嗯	kldn	kldn
印	qgbh	qgbh
限	bvey	bvy
依	wyey	wyey
断	onrh	onrh
轻	lcag	lcag
环	ggiy	gdhy
简	tujf	tujf
趣	fhbc	fhbc
志	fnu	fnu
响	ktmk	ktmk
随	bdep	bdep
练	xanw	xanw
续	xfnd	xfnd
鱼	qgf	qgf
篇	tyna	tyna
司	ngkd	ngkd
局	nnkd	nnkd
送	udpi	udpi
极	seyy	sbyy
角	qej	qej
省	ithf	ithf
源	idri	idri
阳	bjg	bjg
干	fggh	fggh
习	nud	nud
罗	lqu	lqu
武	gahd	gahy
免	qkqb	qkqb
疑	xtdh	xtdh
拉	rug	rug
克	dqb	dqb
仍	wen	wbt
楼	sovg	sovg
佛	wxjh	wxjh
足	khu	khu
低	wqay	wqay
广	yygt	oygt
烦	odmy	odmy
鸟	qyng	qgd
显	jogf	jof
码	dcg	dcgg
土	ffff	ffff
率	yxif	yxif
圣	cff	cff
坏	fgiy	fdhy
初	puvn	puvt
具	hwu	hwu
预	cbdm	cnhm
呀	kaht	kaht
众	wwwu	wwwu
责	gmu	gmu
争	qvhj	qvhj
兵	rgwu	rwu
误	ykgd	ykgd
境	fujq	fujq
青	gef	gef
顺	kdmy	kdmy
野	jfcb	jfch
楚	ssnh	ssnh
贵	khgm	khgm
若	adkf	adkf
爷	wqbj	wrbj
负	qmu	qmu
压	dfyi	dfyi
史	kqi	kri
适	tdpd	tdpd
测	imjh	imjh
怀	ngiy	ndhy
迎	qbpk	qbpk
配	sgnn	sgnn
慢	njlc	njlc
懂	natf	natf
